'....ABBBBBBBBBBC....',
'....DEEEEEEEEEEF....',
'....G..........H....',
'....G..........H....',
'....G..........H....',
'....G..........H....',
'....GBBBBBBBBBBH....',
'....GEEEEEEEEEEH....',
'....G..........H....',
'....G..........H....',
'....G.....P....H....',
'....G..........H....',
'....G..........H....',
'....IJJJJJJJJJJK....',
'....................',